  skill-1:
    input: select
    label: "Skill-1"
    options: &skill-list
      Academics: Academics
      Computer: Computer
      Crafts: Crafts
      Investigation: Investigation
      Medicine: Medicine
      Occult: Occult
      Politics: Politics
      Science: Science
      Athletics: Athletics
      Brawl: Brawl
      Drive: Drive
      Firearms: Firearms
      Larceny: Larceny
      Stealth: Stealth
      Survival: Survival
      Weaponry: Weaponry
      Animal Ken: Animal Ken
      Empathy: Empathy
      Expression: Expression
      Intimidation: Intimidation
      Persuasion: Persuasion
      Socialize: Socialize
      Streetwise: Streetwise
      Subterfuge: Subterfuge
  skill-1-value:
    input: integer
    label: "Rank-1"
    placeholder: "0"
    min: 0
    max: 5