SURAU & TANDAS STAFF
NURUL ASYIQIN BINTI ZUKAMARUDIN	CASHIER
NURUL FATIHAH BINTI MOHD RAWI	HARDLINE
SITI NOR ARIESYA AYUNIE BINTI SHAMSURI	SUNDRIES / TOILETTRIES
KHAIRUNNISANORLIYANA BINTI ZAHARI	GROCERY
NOR AZREEN BINTI YAZMAN	FRESH MARKET / FROZEN
NIK NURSYAIMA AINAA BINTI CHE RAMLI	CASHIER
MUHAMMAD AZIZUL BIN MAT GHANI	FRESH MARKET / FROZEN
MUSLIANY BINTI IBRAHIM	FRESH MARKET / FROZEN
SITI HAZIMAH BINTI MOHD SHAKRI	SOFTLINE
NUR AINMIRZA BINTI RAMLI	SOFTLINE

CERMIN DEPAN
NURUL IZZATI BINTI ZAHAMIN	SUNDRIES / TOILETTRIES
NIK NUR AFIQAH BINTI NIK LAH	GROCERY
NIK MUHAMMAD RUHUL AMIN BIN NIK MAHMUD	HARDLINE
NORFATIN ERNY BINTI SHAHIDUL BAHARI	CASHIER
NURUL AINI BINTI MOHAMAD	FRESH MARKET / FROZEN
NURUL SYUHADA BINTI NOR HISHAM	CASHIER
FATANAH BINTI ABDUL AZIZ	FRESH MARKET / FROZEN
MUHAMAD SHARIF BIN GHAZALI	SOFTLINE
NUR AMIRAH IYLIA BINTI CHE AZIZ	CASHIER
MUHAMMAD ADIB RIFQI BIN MOHD NAZERI 	GROCERY

TANDAS CUSTOMER & PARKING MOTOR
MOHAMAD HAFIZ BIN MOHD SAYUTI	SUNDRIES / TOILETTRIES
NURUL ASYIQIN ATHMAR BINTI OMAR AHLAL BADRIE	SOFTLINE
MUHAMMAD ZAKWAN BIN ZULKIFLEE 	HARDLINE
NUR FATIHAH BINTI RAMLI	CASHIER
MOHAMAD FIKRI BIN MOHD KHAIZURAN	FRESH MARKET / FROZEN
AMIRUL NAIM BIN ZAINUDDIN	SOFTLINE
SYAFIRA BINTI AZMI	CASHIER
ASMAA HAFIEZAH BINTI ABDULLAH	GROCERY
NUR ATHIRAH BINTI MOHD RAJI	FRESH MARKET / FROZEN
NUR ALIYA IMANI BINTI MOHD NOOR	GROCERY

PARKING DEPAN
SHAFUDIN BIN MUHAMAD	SUNDRIES / TOILETTRIES
AZHANA BINTI AB AZIZ	FRESH MARKET / FROZEN
NUR FADILAH BINTI SANDI KUSHAIRI	HARDLINE
NOOR HAZWANI BINTI ABDUL AZIZ	CASHIER
MUHAMMAD AMIR HAKIM BIN YUSOFF	FRESH MARKET / FROZEN
IZYAN SYANIM BINTI IZUAN 	SUNDRIES / TOILETTRIES 
RAJA NURFARAHANIS BINTI RAJA SAKTI	CASHIER
MUHAMMAD HARRIZ BIN HASHIM	GROCERY
MUHAMMAD ADIEB SYAHMI BIN ZA'AWAVI	FRESH MARKET / FROZEN
PUTRI NUR BAHIYAH BINTI MOHAMED DIN 	GROCERY
