YEIOJSHGDJOFWEIGHEWO = "ZXVHGVJBKLEUEWIOWEJD"
SJDGUDSFYEIWIYEGFSJA = "LMSCAJHFDHYTWAUIWAWA"
UYFSATYGDUSAHUIDEIEX = "NBJEUWWEIFBDJKSGABCJ"
IOPSADVGHASFUYGEWHJJ = "YWQBQWCVBNAKSIUQKAAS"
VASCNSBAJHCAGSIGWYIA = "VCVNXCASIUGWOAKSLOHF"
GHUWDBQWQDJQVDKAAIHW = "CVXBASCXVZKLIOEWJNNF"
xYOUR = "n"
xMOM = "t"
xIS = "o"
xA = "a"
xGAY = "c"
xASS = "s"
xMAN = "i"
ASKJGDASKYDUWEWJKDBC = math
JADDYUWIUQWQWIUDGWVF = ASKJGDASKYDUWEWJKDBC[xASS..xMAN..xYOUR]
BVSAIODUIEJWEOWHAASX = ASKJGDASKYDUWEWJKDBC[xGAY..xIS..xASS]
POWUEWJFEBWVUFYFVSDB = ASKJGDASKYDUWEWJKDBC[xMOM..xA..xYOUR]
UYDQTWYGHQDWJBDVHCAJ = ASKJGDASKYDUWEWJKDBC[xA..xASS..xMAN..xYOUR]
OASIIDUGEYUEWHDWEKWS = ASKJGDASKYDUWEWJKDBC[xA..xGAY..xIS..xASS]
TERWEBDEDHOWQIOKVJKK = ASKJGDASKYDUWEWJKDBC[xA..xMOM..xA..xYOUR]
function ASJHMDSAGKHGSADHJASFG(PIWQINJCIZUXYLABZ,CVBNMCEUIEILKWJEVS,ASUYDUGEGFCHIAUWTHW) 
    if PIWQINJCIZUXYLABZ == "ZXVHGVJBKLEUEWIOWEJD" then
        return JADDYUWIUQWQWIUDGWVF(CVBNMCEUIEILKWJEVS)
    elseif PIWQINJCIZUXYLABZ == "LMSCAJHFDHYTWAUIWAWA" then
        return BVSAIODUIEJWEOWHAASX(CVBNMCEUIEILKWJEVS)
    elseif PIWQINJCIZUXYLABZ == "NBJEUWWEIFBDJKSGABCJ" then
        return POWUEWJFEBWVUFYFVSDB(CVBNMCEUIEILKWJEVS)
    elseif PIWQINJCIZUXYLABZ == "" then
        return (CVBNMCEUIEILKWJEVS)
    end
end
print(ASJHMDSAGKHGSADHJASFG(YEIOJSHGDJOFWEIGHEWO,9999,"joe"))
